
24 20
576 576
1 1 1 1 1 1 1 1 1 1 1 1 1 1 1 1 1 1 1 1 1 1 1 1
0 0 0 0 0 0 0 0 0 0 0 0 0 0 0 0 0 0 0 0 0 0 0 0
1 0 1 1 1 1 1 1 0 1 1 1 1 4 1 1 1 1 1 1 2 2 0 1
1 0 1 1 2 2 1 1 0 1 1 1 1 1 1 1 1 1 4 1 4 1 0 1
1 0 1 4 1 1 4 1 0 1 1 1 1 3 1 2 1 1 1 1 1 1 0 1
1 0 1 1 4 1 1 2 9 2 1 4 1 1 1 3 1 1 1 1 3 1 0 1
1 0 1 1 3 1 3 1 1 1 1 3 1 1 1 1 1 1 3 1 1 1 0 1
1 0 1 4 1 1 1 1 0 1 1 1 1 1 1 4 1 1 1 1 1 1 0 1
1 0 1 1 1 1 1 1 0 1 2 2 2 2 1 1 1 1 1 1 1 1 0 1
1 0 1 3 1 1 4 4 0 1 1 1 1 1 1 1 3 3 1 1 4 1 0 1
1 0 1 1 1 1 1 1 0 1 2 2 2 2 1 1 1 1 1 4 1 1 0 1
1 0 1 1 1 1 3 3 1 1 2 2 2 2 1 8 2 4 1 1 1 1 0 1
1 0 1 1 1 1 1 1 4 1 1 1 1 1 1 1 1 1 1 1 3 1 0 1
1 0 1 1 4 1 4 1 0 1 1 4 1 1 1 1 1 3 1 1 1 1 0 1
1 0 2 2 1 1 1 1 3 1 1 1 1 1 1 1 4 1 1 1 4 1 0 1
1 0 2 1 3 1 1 1 1 1 1 3 1 1 1 1 1 1 1 4 1 1 0 1
1 0 0 0 1 1 3 1 0 0 0 0 0 0 0 1 3 1 0 0 0 0 0 1
1 0 1 1 1 1 1 1 0 1 1 1 1 1 1 1 1 1 1 3 1 1 0 1
0 0 0 0 0 0 0 0 0 0 0 0 0 0 0 0 0 1 1 1 1 0 0 0
1 1 1 1 1 1 1 1 1 1 1 1 1 1 1 1 0 0 0 0 0 0 1 1