
24 20
576 576
1 1 1 1 1 1 1 1 1 1 1 1 1 1 1 1 1 1 1 1 1 1 1 1
0 0 0 0 0 0 0 0 0 0 0 0 0 0 0 0 0 0 0 0 0 0 0 0
0 1 1 2 2 2 1 1 1 1 1 1 1 1 4 1 1 1 1 1 1 1 1 0
0 1 1 2 2 2 1 1 1 1 1 1 1 1 1 1 1 3 1 1 1 1 1 0
0 1 1 4 1 1 1 3 1 1 1 1 1 1 4 4 1 0 0 0 0 0 0 0
0 1 1 4 1 1 1 1 1 1 1 1 1 1 1 1 2 0 1 1 1 1 1 1
0 1 3 1 2 1 1 1 1 1 4 1 1 1 1 1 1 0 1 1 1 1 1 1
0 1 1 1 1 1 1 1 1 1 1 1 1 1 1 4 1 0 1 1 1 1 1 1
0 1 2 1 1 1 1 1 4 3 4 1 2 1 1 1 1 0 0 0 0 0 0 0
0 1 1 1 1 1 1 1 1 1 1 1 1 1 1 1 1 1 1 1 1 1 1 0
0 1 2 3 4 1 1 1 1 1 1 2 2 1 1 2 1 1 1 1 1 1 2 0
0 2 1 1 4 1 2 2 2 1 1 1 1 1 1 1 3 1 1 1 4 1 1 0
0 1 1 1 1 1 5 2 2 1 1 1 2 1 1 1 1 4 4 1 1 2 1 0
0 1 1 1 1 1 1 1 1 1 1 1 1 1 4 4 4 1 1 1 3 1 0 0
0 1 2 1 1 1 3 1 1 1 1 3 1 1 1 1 1 1 0 0 0 0 0 0
0 1 1 1 1 1 1 1 4 1 4 1 1 1 1 1 1 3 0 1 1 1 1 1
0 0 0 0 0 0 0 1 1 1 1 1 2 1 1 1 1 1 0 1 1 1 1 1
1 1 1 1 1 1 0 1 1 1 1 1 1 1 1 1 1 1 0 1 1 1 1 1
1 1 1 1 1 1 0 0 0 1 2 1 2 2 1 4 0 0 0 1 1 1 1 1
1 1 1 1 1 1 1 1 0 0 0 0 0 0 0 0 0 1 1 1 1 1 1 1