40X22

0: Mur
1: Mud
2: Vide (mud ou t'as marché par exemple)
3: Diamond
4: Boulder
5: un mob
6: un autre mob

0000000000000000000000000000000000000000
0211111111111111111111111111111111111110
0111111111111111111111111111111111111110
0111111111111111111111111111111111111110
0111111111111111111111111111111111111110
0111111111111111111111111111111111111110
0111111111111111111111111111111111111110
0111111111111111111111111111111111111110
0111111152211111522111115221111152211110
0111111122211111222111112221111122211110
0111111123211111232111112321111123211110
0111111111111111111111111111111111111110
0111111111111111111111111111111111111110
0111111111111111111111111111111111111110
0111111152211111522111115221111152211110
0111111122211111222111112221111122211110
0111111123211111232111112321111123211110
0111111111111111111111111111111111111110
0111111111111111111111111111111111111110
0111111111111111111111111111111111111110
0111111111111111111111111111111111111119
0000000000000000000000000000000000000000

0000000000000000000000000000000000000000
0211111411111111111111111111411111111410
0111114111111111111114111111111111111110
0111111114114111111111111111111111111110
0411111111111111111111111111111111111110
0111111111111111111141111111111111111110
0141111111111111111111114111111111411110
0114111114111111111114114111111111111140
0111111411111141111111111111111111114110
0111111112611141126111111261111112611110
0111111112211141122111111221111112214110
0111111111111111111111111111111111111110
0111411111111111111111111111111111141110
0111411111411111111111111111111111111110
1111114111111111111411111111111111111140
0111111111114111111141111111111111111110
0141111111111111114111111111111111111110
0111111111111111111111411111111141111110
0111111111111111111111111111111114114110
0111411111114144111111111111111111411110
0111111111114144111111111141141411111119
0000000000000000000000000000000000000000


0000000000000000000000000000000000000000
0111111141141111114113143411111413111140
0114411411111111311411411411111311111149
0312114111311111111414113114111141414430
0141111131144411111411311314113111111140
0111114111311411111114143413411141141130
0111141111113111401101111111314113111110
0111311113441111104101114111114414441110
0111111411114131101301111441144111113140
0314111114141144101401414114114111114410
0313111141144131101104111141114141141110
0000000000000000001300000000000000000000
0434141413111111101101111414411114131110
0111144331111131104101141411131411411110
1111114411113111101101141111111111111410
0111141111141114101101333131411134111110
0411141141111111301104114111111111141110
0143141114111143111111111111111111111140
0431111414111114144111131411341111441110
0414444313114114143111441131114111114440
0000000000000000000000000000000000000000
